00000000000
02222222220
02010101020
02111111120
02010101020
02111511120
02010101020
02111111120
02010101020
02222222220
00000000000
